%%%%%%%%%%
%.  %   .%
% %.% %% %
% %   .%.%
% .%P%   %
%.  .  . %
% %%%% %.%
%.    .% %
%%%%%%%%%%
